111111111111111111111111111111
1PE00001C101010110000000010101
110000000101000111000000010101
1C000000C101010000000000010101
100000000101000110000000010101
100000000101000110000000010101
100000000000000110000000000001
110000000101000111000000010101
100000000101000110000000010101
100000000101000110000000010101
100000000101000000000000010101
100000000101000000000000010101
100000000101000000000000010101
100000000101000000000000010101
100000000101000110000000010101
111111111111111111111111111111
