1111111111111111
1P0000C000C000E1
1111111111111111
