1111111111111111
1P0000C000C000E1
100000C000C00001
100000C000C00001
100000C000C00001
100000C000C00001
100000C000C00001
1111111111111111
