111111111111111111111111111111
1P0000C001C10101100000C001C101
110000C001010E01110000C0010101
100000C001C10101100000C001C101
100000C001C10001100000C001C101
100000C001C10001100000C001C101
100000C000000001100000C0000001
110000C001010001110000C0010101
100000C001C10001100000C001C101
100000C001C10001100000C001C101
100000C001C10001100000C001C101
100000C000000001100000C0000001
110000C001010001110000C0010101
100000C001C10000000000C001C101
100000C001C10000000000C001C101
111111111111111111111111111111
