1111111111111111
1P0000C001C101E1
110000C001010001
100000C001C10001
100000C001C10001
100000C001C10001
100000C000000001
1111111111111111
