111111111111111111111111111111
1P0000C00101010110000000010101
110CCCCCC1C10E0111000000010101
100000000101010110000000010101
100000000101000110000000010101
100000000101000110000000010101
100000000000000110000000000001
110000000101000111000000010101
100000000101000110000000010101
100000000101000110000000010101
100000000101000110000000010101
100000000000000110000000000001
110000000101000111000000010101
100000000101000000000000010101
100000000101000000000000010101
111111111111111111111111111111
