111111111111111111111111111111
1PE000C00101010110000000010101
110CCCCCC1C1000111000000010101
100000000101010110000000010101
100000000101000110000000010101
100000000101000110000000010101
100000000000000110000000000001
110000000101000111000000010101
100000000101000110000000010101
100000000101000110000000010101
100000000101000110000000010101
100000000000000110000000000001
110000000101000111000000010101
100000000101000000000000010101
1CCCCCCCC101000000000000010101
111111111111111111111111111111
