111111
1P0CE1
100001
100001
100001
111111
